###########################################
##   #  ### s       # ##   ####        ## #
##  # ### ###         # ###  #      #   # #
#  #    #  #          # # ##     #  # ### #
# # # #    ###        #  #  ## # #  #     #
##   #  # ##             #   ##  ### # #  #
###   #    ### ##        ## ##  #    # # ##
#      #  #     # #    #    #   # #  #  ###
##         #  # ##  # # ##  #   #  #     ##
##  # #      ## #  # # #  #       #       #
# #    ##  ###       ####   #    # #  #   #
##      #  ## ##  # # # #     #           #
##           # #           #       ##     #
# ##    # #  #  ####     ## #  #  #  #    #
##     #  ## ##  #   #  #        #     #  #
##       ##  #      ##  #e  #       #  #  #
###########################################