#########
#s#   #e#
# # #   #
#     # #
#########