################################################################################################################################################################
#        #   ##   # ##     #   #    ##   #     #  #    #  ####      # #  #   #    #   #        #   ## #  ## s   ####      ##      #  #       ## # #####  #  # ##
#  #  #   #     ##   ###   ###  ## # #     # # ## # ## ##  #  #        #  # # ##  # # ##   # #  # #   ##     ## ### #  #   #     #   #     #  # # #  ###  ### ##
# #    ##   #     ##               #  #    ## #   #  #### # #   # # ##  ##   #     ##     #    #    #   # #   # # # #   ## ###      ## # ## #  #       ### ##  #
# #     ##   #   #  #   # #  #    # ## ### ##   # #   #    # # # # #    # # #   #     #     # ####  #   #   #     #  # ##    # # ## ## #    ## ## #   #  #    ##
#  #    ##  #  #    ##      #####    #     ##      ##   #  # #  #    ## #          #      ##           ##       ##    #  ##      ###       ##  #    ##   #  # ##
## #    #     #   ##  # #    #    #   #     # ###     #      #  #      ##         # ###   ##      ###  # #  #  # ##       # ##  #        ### #       # # ## ## #
#    # ##  # #   # ##  #    #     # # #    #          # # ###  #     #     ##     #    ###     ## ###  #     # #  #        # #   #   #  ### # #  ## #######    #
#               #   # # ##     #  ##  #   #    ##      #            ####   ##    # #        #  #### #  #   ## ##     #   ## # ###    ##  #### #     #  #       #
#  ## # ##  ## # #   #####  #   #  #  # ##    #  ##### ## #        ##   ### ###  #     #    ##   ##    #     ##   #    #  #   #     #  ##    ## # ##       #   #
# ###   ###      ##    ##    #      # # ##    ##  # #    ##    # #### # # #   # #  ## #     ###     #  #        #  #  ##    #   #### #      #  # ##   ##      ##
# ##  ##   #   # # #  ##       # #   #    #     #  # ## ###   ## ## #   #     #    #  ## ##    # #     #          #  #  ##         # #    #       ## ##   #   ##
#  #   #       #    #    #  #  ##      #   ###   # ### #  #       ## #     # #    ## #      #   #   #  # ##      ##  ###  ##      #  # ##   #   # ##  ##   # ###
###     # #   ##  #       # #   #    ###   ##      #  ##    # #  #  ###       #  ## # ##### # #     ##  ##    ## #              #    #     ##  ##       ## # # #
##   ##  ##          #    #   #   #    # ## ###      #       ##     #     #         #  #   ###   #   ##  ###       # ### #  #     #  ##    ##         #        #
##  # ##  #        #   #  ##    #  #       # #   #   ## ## ###      # #    ##  # # ##   ###     ##        ## ## #  #       #    #  # ##  ##   #    ##    ####  #
##   #   ##   ###  #  #        ##  ### #   #  #             #   # ## ## #     # #     #     #  #        # # ##   #           # ##      # #          #    ## # ##
# ## #  #  # ## #  # # ##  ####   #    # #    #         #  # #  ### #     ###   #  #  #  #  ####    ## #   ##        #   #      # ### #      # # #   #      #  #
#  ##  # ##     # ## # ###  ##   #   # ##           ##  # ##  #    ####  #       ##     #     #  #     #  # #   #   ## #     # ###  #            ####  ###   # #
# # #  ####    #     #    ##        ##  ##    ##    #      # ##     #### #  # #  # #  #    #    #  #      #  ##     ## ##   #    ##         #   #   #  #       #
#  # # ##     ##     #   #    ##     #   #    #  #  #   ## #   #          ### #  # # #  #  #     #  # ##    ##       #  #  #  # #  #  #  ##  ##  #  #     # # ##
#      # ##      # #####      #   #  # #  #     #### #          ###      #    #  #  ##      ##       #  ## # #  # #      ##    ####    #    ## ## ##  #        #
# #   #   ##     # ####       ###  # #  # #       #  ## #     # # # ##  #  #  ##      ##        #   ###   #    # #  #      # #  ##   ##   #       #### #  #  ###
# #  ### #             #   # #    ###     # #       # ##  # #  #    #         ### ##      # #   #  #  #  #  ##     # ##### #  # #     #     #    ##     #  #   #
#   #               # #  # # # #      # ##     ##  ## # # #  # # #  # #  #           ##   ##     #  #  ##### # #  #  #  ## #    ####  # ##   #    # #    # # # #
### # ## #   #####    #    ##  #      ## #  # # ## #     ##    #  ######   #### #    #       #   #   #   ## ##       #  ## #     # ## #  ## #  ##   ###    #   #
##      #     #  # # # # # ###  # #  # #   #         # ##   #         #  ##      #   ###   ##  #  #    #      # # #     #  #  #     #   #  #  ### ### ##   ##  #
#    ## #   # #   #  ##        ##         ####  #     #### ##  #   ## #   ##   #    # #### ###  ###   #  #   #  ##      # #    # ##  ## #  #     ####    #  ####
#           #      #     # ##   #   #          #   # #   # # # # ##       #    # # # ###  #     #  # #  #     ##    #         ## ##  ######  ###   # # #     # #
##  # # ## # ##  #    ## #   #    ## #    # # #       #       #  # #   #   #  # ##   #      #     # #   #   #    #          #   # #  ## # ## #  ##    ##  #    #
#  #   #   #    #          ##     ## #     #    ## ####  #   ##      ##     # ##   #      #      # #####  ## # # # #          ##      # ## ##  #  #   # ##     #
#  #  ###  #       #           ##   # ## # # # #         ##### # #     ## #       #  #   # ##    #   ##  ##      #    ## ##       #  #       # # ##  ##     #  #
# # #    #   #### #  ## ###  ##  #    #      #    ## #   #    #     # ###   ##  ##  #    #   #    # ## #                ##   ##  # #    # #         # # # #   ##
#  ### # #  #       ###  #  ##  ##  ###  ### ##    ##      ##   ## ## ##   ## # ##     #   # # # #      #               #  #  #         #     # #     #  #     #
###    ##      #      ##           #   # ##### #     # #  # #    ## ## # #        # #  #        # ###    ## # # ##     ## ## ###  ##   ##    ### #   # # #### ##
#  #     ## ####  ##   ###           # # #   ## ##    ###  #   ###  ##     #   # #    #     ### #        #    ## #   ## ##     #         # # ##  # #  #  #   ###
# ## # # #   #   #        ###   #  #  ###     ###    # # #           ## #  ##  #          # ##  ## #    ## # # #### #   ####  #####   # # # # ## # #      # #  #
## # #                     ##    # # #  #  ###        #     #   # # ###  #    ##  #     # #  ##  ##        ####  # #  #  ##   #   #   #      #         ## #  # #
#    ## #  #  ####    ## #### #  #  ## ####  #      #   #  #        #     ## ## ###    ###   # # #    #    #     # # #  #          # # ### #   #      ##  #### #
#    #      # # #     # #  #  # #  #   #   #    #   ### # ###  # ###                   ##   ###      ##  #    #     #   #   ####        #  ## #    #    #     ##
### # #     #     #       #         ## #  #     #    #      # ## #   #  # #####    ##  ##   ## ###  #  #  ########   ## # ##      #   # #    ## #  #       #   #
### ### ###  #       #   #    ####       #    #  #  ##          #    #          #         #              ###   # ## #   #   #   # #  ###            # ##       #
#  # #  #  ### ##  #  #   #   #     # ## #    #     #   ## #    # ##   ## #  #    # ##      #  ##     ## ## # ###  #   # #  # #      #    ##   #   ###         #
#   ###  # #   ## #  ## #    #  #      #    #   ##    ##  ###    #  # #    ##    ##   ###      #    #   # # #   #     #    #        ## ##     ######  ### #   ##
# #   # # # #     ##   #   #  #  ##       # ## # ##         #   ##  # #        #  # ## #      ##  # #    ###      ##    #      #     # ###  ##  #    ###   #   #
#     #  #   ##    ##     #         #    ##        #   #       #      #     ###### ## # #    # ##     # ### #     ##  #   #      # #     #     ##  # ### ##   ##
##  #  ###    #  #   ##   # #    #    #  #  #  #    ### # #### #  # #       #     #    ##     ##   #  #  ## #  #  #      ## #        # ###   #    #     ## # # #
# ##  # ##       ##  # ##     #     #   ##   #       ##   ##   #      # # ###     #   #    #     #  #        ##  # #  #            ## #  ##  # #      # # #    #
##    #####          # #   ##    #  # ## ##   #     #      ## ### ##        ###  ## #     #   # #  ### ##   #   #    # ####  ##  # #   ## #  # #### ##     #   #
##      #   #  #   #   #    #    ###    ## ## ###   # #              ##  #    #   ##  ### #  #   #   #   # #   #######    #  #          # ###    #  ##   ##    #
#### #  ### ##  ###      #   #  ##  # #        #  #  ## ####   #          #   # #  # ##  # ##  #   #    #        # #  ###  ##  #  #  ##   # ### #  #  #   ###  #
##   ##         ##       #         # #  # #   #   # # #   ## ###    ##   #     ##   #    ###   # # #  ## #    #  #  #  ## #      #  ##    #  # # #          # ##
# #             #      ##  # #  #      ####     #  ###### # ## #  ##          #    #  # ## #     #  #  #     ##   # ###   #    #  #     #  #    #  #       ### #
##  ## # # #    #  #  # ##     #   #      ###  #  ###      # ###     ##   #    #    #  #   ##    #    #             ##   ###   # #   ##            #      ## ###
## ##  ### # #     #     ##   #   #     ###  #   ##  # #   #      # # #    #  #    #    #  #        ###  #       # #  # #     #     #   #  #     #   #  ##  #  #
# ##  #  # #  ### #       ##   ##   ##   # ###      #     ##     ##### ### #  ## #   #          #   ##    #   # # #   #       ## ##  #     ## # # # #  ##   ## #
#     #   # # #    #   ### #     # # ##  ###      ##  #####  # #    #    #    ##     ## #  #  #    #       # #  #     ##  # ####     # #   #    #  ###   ###   #
#  ####    ##  #  #   ###   #  #   #  # #  #               #      # # #   ###  #    #     # #       #       #  ##       #       # #  ## # #   ###    #     #   #
#  #      e            #        # # ## #      #     ## #   ###        ##    #  #  # #   ##  #     #  #   #       #  #### #    # #  #    #   #### ## ## #     ###
################################################################################################################################################################